[console_scripts]
assistant = pyqt5_tools.entrypoints:assistant
canbusutil = pyqt5_tools.entrypoints:canbusutil
designer = pyqt5_tools.entrypoints:designer
dumpcpp = pyqt5_tools.entrypoints:dumpcpp
dumpdoc = pyqt5_tools.entrypoints:dumpdoc
lconvert = pyqt5_tools.entrypoints:lconvert
linguist = pyqt5_tools.entrypoints:linguist
lprodump = pyqt5_tools.entrypoints:lprodump
lrelease = pyqt5_tools.entrypoints:lrelease
lrelease-pro = pyqt5_tools.entrypoints:lrelease_pro
lupdate = pyqt5_tools.entrypoints:lupdate
lupdate-pro = pyqt5_tools.entrypoints:lupdate_pro
pixeltool = pyqt5_tools.entrypoints:pixeltool
pyqt5designer = pyqt5_tools.entrypoints:pyqt5designer
pyqt5qmlscene = pyqt5_tools.entrypoints:pyqt5qmlscene
pyqt5qmltestrunner = pyqt5_tools.entrypoints:pyqt5qmltestrunner
pyqt5toolsinstalluic = pyqt5_tools.entrypoints:pyqt5toolsinstalluic
qdbus = pyqt5_tools.entrypoints:qdbus
qdbuscpp2xml = pyqt5_tools.entrypoints:qdbuscpp2xml
qdbusviewer = pyqt5_tools.entrypoints:qdbusviewer
qdbusxml2cpp = pyqt5_tools.entrypoints:qdbusxml2cpp
qdistancefieldgenerator = pyqt5_tools.entrypoints:qdistancefieldgenerator
qdoc = pyqt5_tools.entrypoints:qdoc
qgltf = pyqt5_tools.entrypoints:qgltf
qhelpgenerator = pyqt5_tools.entrypoints:qhelpgenerator
qlalr = pyqt5_tools.entrypoints:qlalr
qml = pyqt5_tools.entrypoints:qml
qmlcachegen = pyqt5_tools.entrypoints:qmlcachegen
qmleasing = pyqt5_tools.entrypoints:qmleasing
qmlimportscanner = pyqt5_tools.entrypoints:qmlimportscanner
qmllint = pyqt5_tools.entrypoints:qmllint
qmlmin = pyqt5_tools.entrypoints:qmlmin
qmlplugindump = pyqt5_tools.entrypoints:qmlplugindump
qmlpreview = pyqt5_tools.entrypoints:qmlpreview
qmlprofiler = pyqt5_tools.entrypoints:qmlprofiler
qmlscene = pyqt5_tools.entrypoints:qmlscene
qmltestrunner = pyqt5_tools.entrypoints:qmltestrunner
qscxmlc = pyqt5_tools.entrypoints:qscxmlc
qtattributionsscanner = pyqt5_tools.entrypoints:qtattributionsscanner
qtdiag = pyqt5_tools.entrypoints:qtdiag
qtpaths = pyqt5_tools.entrypoints:qtpaths
qtplugininfo = pyqt5_tools.entrypoints:qtplugininfo
qvkgen = pyqt5_tools.entrypoints:qvkgen
qwebengine_convert_dict = pyqt5_tools.entrypoints:qwebengine_convert_dict
repc = pyqt5_tools.entrypoints:repc
testcon = pyqt5_tools.entrypoints:testcon
uic = pyqt5_tools.entrypoints:uic
xmlpatterns = pyqt5_tools.entrypoints:xmlpatterns
xmlpatternsvalidator = pyqt5_tools.entrypoints:xmlpatternsvalidator

